70
####################
#  A   A    A   A  #
# ### # #### # ### #
# # #A#      #A# # #
# ### # #  # # ### #
#     #A#  #A#     #
# ##### #  # ##### #
#A# A          A #A#
# # #####AA##### # #
#   SSSS           #
#   A          A   #
# #####A####A##### #
#  A    #  #    A  #
# ### # #### # ### #
# # # #  AA  # # # #
#A###A#A####A#A###A#
#A    # #  # #    A#
# ##### #### ##### #
#                  #
####################

