50
####################
#                  #
# ### #A####A# ### #
#  A  #  AA  #  A  #
# ### # #### # ### #
# #A     AA     A# #
# # ###A####A### # #
#   #   #  #   #   #
#   #   ####   #   #
#   SSSS           #
#    A#      #A    #
#   # # #### # #   #
#   #   #  #   #   #
# # ###A####A### # #
#A#      AA      #A#
# ###A# #### #A### #
#  A  #  AA  #  A  #
# ### # #### # ### #
#                  #
####################
