####################
#                  #
#       ###        #
#                  #
#                  #
#                  #
#                  #
#                  #
#       ###        #
#                  #
#                  #
#                  #
#                  #
#                  #
#       ###        #
#                  #
#                  #
#                  #
#                  #
####################

