####################
#                  #
# ### # #### # ### #
# # # #      # # # #
# ### # #  # # ### #
#     # #  # #     #
# ##### #  # ##### #
# #              # #
# # #####  ##### # #
#   SSSS           #
#                  #
# ##### #### ##### #
#       #  #       #
# ### # #### # ### #
# # # #      # # # #
# ### # #### # ### #
#     # #  # #     #
# ##### #### ##### #
#                  #
####################

