 XXXXXXXXXXXXXX
 XXXXXXXXXXXXXX
 XXXX     XXXXX
 XXXXX   XXXXXX
 XXXXXX XXXXXXX
 XXXXX   XXXXXX
 XXXX     XXXXX
 XXXXXXXXXXXXXX
 XXXXXXXXXXXXXX