    XXXXXXXXX
    X   X   X
    XXXXXXXXX
    XXXX XXXX
      XXXXX